お客様にお茶をお出ししております|お客様にお茶をお出ししております|おきゃくさまにおちゃをおだししております|We are serving tea to the customers
会議が延期になりましたことをお詫び申し上げます|会議が延期になりましたことをお詫び申し上げます|かいぎがえんきになりましたことをおわびもうしあげます|We apologize for the meeting being postponed
昨日お預かりした書類を確認いたしました|昨日お預かりした書類を確認いたしました|きのうおあずかりしたしょるいをかくにんいたしました|I confirmed the documents entrusted to us yesterday
雨が降る恐れがございますので傘をお持ちください|雨が降る恐れがございますので傘をお持ちください|あめがふるおそれがございますのでかさをおもちください|Please bring an umbrella as there is a chance of rain
ご注文を承っておりますが少々お時間を頂戴いたします|ご注文を承っておりますが少々お時間を頂戴いたします|ごちゅうもんをうけたまわっておりますがしょうしょうおじかんをちょうだいいたします|We have received your order, but it will take a little time
お忙しいところ恐縮ですがご確認をお願い申し上げます|お忙しいところ恐縮ですがご確認をお願い申し上げます|おいそがしいところきょうしゅくですがごかくにんをおねがいもうしあげます|I apologize for interrupting your busy schedule, but please confirm
新商品の開発に着手しております|新商品の開発に着手しております|しんしょうひんのかいはつにちゃくしゅしております|We have started developing a new product
お席にご案内申し上げますのでこちらでお待ちください|お席にご案内申し上げますのでこちらでお待ちください|おせきにごあんないもうしあげますのでこちらでおまちください|Please wait here, and we will guide you to your seat
ご質問がございましたらお気軽にお申し付けください|ご質問がございましたらお気軽にお申し付けください|ごしつもんがございましたらおきがるにおもうしつけください|Please feel free to let us know if you have any questions
本日のおすすめは季節限定のデザートでございます|本日のおすすめは季節限定のデザートでございます|ほんじつのおすすめはきせつげんていのでざーとでございます|Today’s recommendation is a seasonal limited dessert
お荷物をこちらでお預かりいたします|お荷物をこちらでお預かりいたします|おにもつをこちらでおあずかりいたします|We will take care of your luggage here
ご予約を頂戴しておりますお客様を優先させていただきます|ご予約を頂戴しておりますお客様を優先させていただきます|ごよやくをちょうだいしておりますおきゃくさまをゆうせんさせていただきます|We will prioritize customers with reservations
お支払いは現金またはクレジットカードで承っております|お支払いは現金またはクレジットカードで承っております|おしはらいはげんきんまたはくれじっとかーどでうけたまわっております|Payments are accepted in cash or by credit card
お怪我をなさいませんようお気を付けください|お怪我をなさいませんようお気を付けください|おけがをなさいませんようおきをつけください|Please take care not to injure yourself
ご意見を賜りたく存じますのでお聞かせください|ご意見を賜りたく存じますのでお聞かせください|ごいけんをたまわりたくぞんじますのでおきかせください|We would appreciate your opinions, so please let us know
お食事の準備が整いましたらお呼びいたします|お食事の準備が整いましたらお呼びいたします|おしょくじのじゅんびがととのいましたらおよびいたします|We will call you once the meal is ready
お荷物の紛失にご注意くださいませ|お荷物の紛失にご注意くださいませ|おにもつのふんしつにごちゅういくださいませ|Please be careful not to lose your luggage
ご来店を心よりお待ち申し上げております|ご来店を心よりお待ち申し上げております|ごらいてんをこころよりおまちもうしあげております|We sincerely look forward to your visit
お飲み物のご注文を伺っております|お飲み物のご注文を伺っております|おのみもののごちゅうもんをうかがっております|We are taking orders for drinks
お時間を頂戴いたしますがご了承ください|お時間を頂戴いたしますがご了承ください|おじかんをちょうだいいたしますがごりょうしょうください|We ask for some time, and we appreciate your understanding
お手数をおかけいたしますがご協力をお願い申し上げます|お手数をおかけいたしますがご協力をお願い申し上げます|おてすうをおかけいたしますがごきょうりょくをおねがいもうしあげます|We apologize for the inconvenience and request your cooperation
ご宿泊のお客様に朝食をご用意しております|ご宿泊のお客様に朝食をご用意しております|ごしゅくはくのおきゃくさまにちょうしょくをごよういしております|We are preparing breakfast for our staying guests
お問い合わせの内容を拝見いたしました|お問い合わせの内容を拝見いたしました|おといあわせのないようをはいけんいたしました|I have reviewed the contents of your inquiry
お席が空きましたら順番にご案内申し上げます|お席が空きましたら順番にご案内申し上げます|おせきがあきましたらじゅんばんにごあんないもうしあげます|We will guide you to your seats in order once they become available
ご購入いただいた商品に不具合がございましたらご連絡ください|ご購入いただいた商品に不具合がございましたらご連絡ください|ごこうにゅういただいたしょうひんにふぐあいがございましたらごれんらくください|Please contact us if there is an issue with the purchased product
お急ぎのところ恐縮ですがご対応をお願いいたします|お急ぎのところ恐縮ですがご対応をお願いいたします|おいそぎのところきょうしゅくですがごたいおうをおねがいいたします|I apologize for interrupting your urgency, but please respond
お食事をお楽しみいただければ幸いでございます|お食事をお楽しみいただければ幸いでございます|おしょくじをおたのしみいただければさいわいでございます|We would be delighted if you could enjoy your meal
ご不明な点がございましたらお気軽にご質問ください|ご不明な点がございましたらお気軽にご質問ください|ごふめいなてんがございましたらおきがるにごしつもんください|Please feel free to ask if there is anything unclear
お荷物の配送状況をご確認いただけます|お荷物の配送状況をご確認いただけます|おにもつのはいそうじょうきょうをごかくにんいただけます|You can check the delivery status of your luggage
ご参加をご検討いただければ幸甚に存じます|ご参加をご検討いただければ幸甚に存じます|ごさんかをごけんとういただければこうじんにぞんじます|We would be most grateful if you could consider participating
お支払いの手続きを完了していただけますか|お支払いの手続きを完了していただけますか|おしはらいのてつづきをかんりょうしていただけますか|Could you please complete the payment procedure?
お部屋の清掃を承っておりますので少々お待ちください|お部屋の清掃を承っておりますので少々お待ちください|おへやのせいそうをうけたまわっておりますのでしょうしょうおまちください|We are handling the room cleaning, so please wait a moment
お怪我のないよう十分にご注意くださいませ|お怪我のないよう十分にご注意くださいませ|おけがのないようじゅうぶんにごちゅういくださいませ|Please take sufficient care to avoid injury
ご提案を拝聴いたしまして感謝申し上げます|ご提案を拝聴いたしまして感謝申し上げます|ごていあんをはいちょういたしましてかんしゃもうしあげます|We listened to your proposal and express our gratitude
お届け物の受け取りをお願い申し上げます|お届け物の受け取りをお願い申し上げます|おとどけもののうけとりをおねがいもうしあげます|Please receive the delivered item
ご利用規約にご同意いただけますでしょうか|ご利用規約にご同意いただけますでしょうか|ごりようきやくにごどういいただけますでしょうか|Would you please agree to the terms of use?
お席にご案内する前にご予約を確認いたします|お席にご案内する前にご予約を確認いたします|おせきにごあんないするまえにごよやくをかくにんいたします|We will confirm your reservation before guiding you to your seat
お飲み物の追加をご希望でしたらお申し付けください|お飲み物の追加をご希望でしたらお申し付けください|おのみもののついかをごきぼうでしたらおもうしつけください|Please let us know if you would like additional drinks
ご旅行の計画をお立てになる際にお手伝いいたします|ご旅行の計画をお立てになる際にお手伝いいたします|ごりょこうのけいかくをおたてになるさいにおてつだいいたします|We will assist you when planning your trip
お疲れのところお越しいただきありがとうございます|お疲れのところお越しいただきありがとうございます|おつかれのところおこしいただきありがとうございます|Thank you for coming despite your fatigue