Yo como tacos cada noche|Yo como tacos cada noche|Yo como tacos cada noche|I eat tacos every night
Mi amigo llegó a Guadalajara ayer|Mi amigo llegó a Guadalajara ayer|Mi amigo llegó a Guadalajara ayer|My friend arrived in Guadalajara yesterday
Mi mamá cocina pozole en la cocina|Mi mamá cocina pozole en la cocina|Mi mamá cocina pozole en la cocina|My mom cooks pozole in the kitchen
Él jugará fútbol mañana|Él jugará fútbol mañana|Él jugará fútbol mañana|He will play soccer tomorrow
Mi papá vio televisión anoche|Mi papá vio televisión anoche|Mi papá vio televisión anoche|My dad watched TV last night
Mi hermana quiere escuchar mariachi|Mi hermana quiere escuchar mariachi|Mi hermana quiere escuchar mariachi|My sister wants to listen to mariachi
Ella bebe agua de jamaica en casa|Ella bebe agua de jamaica en casa|Ella bebe agua de jamaica en casa|She drinks hibiscus water at home
Nosotros iremos al mercado|Nosotros iremos al mercado|Nosotros iremos al mercado|We will go to the market
La maestra explicó la tarea ayer|La maestra explicó la tarea ayer|La maestra explicó la tarea ayer|The teacher explained the homework yesterday
Mi abuelo toma café de olla cada mañana|Mi abuelo toma café de olla cada mañana|Mi abuelo toma café de olla cada mañana|My grandfather drinks Mexican coffee every morning
Mi abuela compró tortillas esta mañana|Mi abuela compró tortillas esta mañana|Mi abuela compró tortillas esta mañana|My grandmother bought tortillas this morning
Mi hermano juega pelota en la calle|Mi hermano juega pelota en la calle|Mi hermano juega pelota en la calle|My brother plays ball in the street
Tú visitarás mi casa mañana|Tú visitarás mi casa mañana|Tú visitarás mi casa mañana|You will visit my house tomorrow
Mi primo comió enchiladas ayer|Mi primo comió enchiladas ayer|Mi primo comió enchiladas ayer|My cousin ate enchiladas yesterday
Los niños quieren dulces de tamarindo|Los niños quieren dulces de tamarindo|Los niños quieren dulces de tamarindo|The kids want tamarind candy
Mi mamá lava trastes en la cocina|Mi mamá lava trastes en la cocina|Mi mamá lava trastes en la cocina|My mom washes dishes in the kitchen
Mi tío pescará en el río mañana|Mi tío pescará en el río mañana|Mi tío pescará en el río mañana|My uncle will fish in the river tomorrow
Su papá durmió temprano anoche|Su papá durmió temprano anoche|Su papá durmió temprano anoche|His dad slept early last night
Yo quiero comer chilaquiles con salsa|Yo quiero comer chilaquiles con salsa|Yo quiero comer chilaquiles con salsa|I want to eat chilaquiles with sauce
Mi hermana lee un libro en el sillón|Mi hermana lee un libro en el sillón|Mi hermana lee un libro en el sillón|My sister reads a book on the couch
Nosotros comeremos antojitos juntos|Nosotros comeremos antojitos juntos|Nosotros comeremos antojitos juntos|We will eat Mexican snacks together
El perro corrió en el parque ayer|El perro corrió en el parque ayer|El perro corrió en el parque ayer|The dog ran in the park yesterday
Ella quiere bailar cumbia|Ella quiere bailar cumbia|Ella quiere bailar cumbia|She wants to dance cumbia
Mi amigo corre en la plaza|Mi amigo corre en la plaza|Mi amigo corre en la plaza|My friend runs in the plaza
Mi abuela hará tamales mañana|Mi abuela hará tamales mañana|Mi abuela hará tamales mañana|My grandmother will make tamales tomorrow
Yo bebí agua fresca esta mañana|Yo bebí agua fresca esta mañana|Yo bebí agua fresca esta mañana|I drank fresh fruit water this morning
Los pájaros cantan en el árbol|Los pájaros cantan en el árbol|Los pájaros cantan en el árbol|The birds sing in the tree
Mi mamá prepara atole para todos|Mi mamá prepara atole para todos|Mi mamá prepara atole para todos|My mom prepares atole for everyone
Mi tío irá a la chamba mañana|Mi tío irá a la chamba mañana|Mi tío irá a la chamba mañana|My uncle will go to work tomorrow
Mi hermano jugó videojuegos ayer|Mi hermano jugó videojuegos ayer|Mi hermano jugó videojuegos ayer|My brother played video games yesterday
Los niños pintan en la escuela|Los niños pintan en la escuela|Los niños pintan en la escuela|The kids paint at school
Ella comprará flores en el tianguis|Ella comprará flores en el tianguis|Ella comprará flores en el tianguis|She will buy flowers at the street market
Su papá cortó el césped hoy|Su papá cortó el césped hoy|Su papá cortó el césped hoy|His dad mowed the lawn today
Yo quiero tomar horchata|Yo quiero tomar horchata|Yo quiero tomar horchata|I want to drink horchata
Mi hermana barre el patio|Mi hermana barre el patio|Mi hermana barre el patio|My sister sweeps the yard
Nosotros iremos al zócalo|Nosotros iremos al zócalo|Nosotros iremos al zócalo|We will go to the town square
Mi abuelo caminó en la tarde|Mi abuelo caminó en la tarde|Mi abuelo caminó en la tarde|My grandfather walked in the afternoon
Mi prima ve caricaturas en la tele|Mi prima ve caricaturas en la tele|Mi prima ve caricaturas en la tele|My cousin watches cartoons on TV
Mi mamá limpia la casa hoy|Mi mamá limpia la casa hoy|Mi mamá limpia la casa hoy|My mom cleans the house today
Él estudiará en la biblioteca|Él estudiará en la biblioteca|Él estudiará en la biblioteca|He will study in the library
Mi abuela cocinó mole ayer|Mi abuela cocinó mole ayer|Mi abuela cocinó mole ayer|My grandmother cooked mole yesterday
Mi amigo quiere comer fruta|Mi amigo quiere comer fruta|Mi amigo quiere comer fruta|My friend wants to eat fruit
Mi tío arregla el camión|Mi tío arregla el camión|Mi tío arregla el camión|My uncle fixes the bus
La maestra enseñará español mañana|La maestra enseñará español mañana|La maestra enseñará español mañana|The teacher will teach Spanish tomorrow
Mi hermano desayunó huevos rancheros|Mi hermano desayunó huevos rancheros|Mi hermano desayunó huevos rancheros|My brother ate ranch-style eggs for breakfast
Yo quiero jugar con el perrito|Yo quiero jugar con el perrito|Yo quiero jugar con el perrito|I want to play with the puppy
Mi primo mira televisión en la sala|Mi primo mira televisión en la sala|Mi primo mira televisión en la sala|My cousin watches TV in the living room
Nosotros compraremos comida en el mercado|Nosotros compraremos comida en el mercado|Nosotros compraremos comida en el mercado|We will buy food at the market
Su papá tomó café anoche|Su papá tomó café anoche|Su papá tomó café anoche|His dad drank coffee last night
Mi hermana canta rancheras|Mi hermana canta rancheras|Mi hermana canta rancheras|My sister sings ranchera songs
Mi mamá planta nopales en el jardín|Mi mamá planta nopales en el jardín|Mi mamá planta nopales en el jardín|My mom plants cacti in the garden
Él comprará un sombrero mañana|Él comprará un sombrero mañana|Él comprará un sombrero mañana|He will buy a hat tomorrow
Ella durmió en la hamaca ayer|Ella durmió en la hamaca ayer|Ella durmió en la hamaca ayer|She slept in the hammock yesterday
Mi amigo quiere agua de limón|Mi amigo quiere agua de limón|Mi amigo quiere agua de limón|My friend wants lime water
Mi abuelo está en el sillón|Mi abuelo está en el sillón|Mi abuelo está en el sillón|My grandfather is on the couch
Mi abuela cocinará frijoles mañana|Mi abuela cocinará frijoles mañana|Mi abuela cocinará frijoles mañana|My grandmother will cook beans tomorrow
Mi hermano corrió en la calle ayer|Mi hermano corrió en la calle ayer|Mi hermano corrió en la calle ayer|My brother ran in the street yesterday
Yo quiero comer flan|Yo quiero comer flan|Yo quiero comer flan|I want to eat flan
Mi prima limpia la mesa|Mi prima limpia la mesa|Mi prima limpia la mesa|My cousin cleans the table
Nosotros jugaremos lotería el sábado|Nosotros jugaremos lotería el sábado|Nosotros jugaremos lotería el sábado|We will play lotería on Saturday
Mi hermano estudió anoche|Mi hermano estudió anoche|Mi hermano estudió anoche|My brother studied last night
Mi mamá escucha radio cada día|Mi mamá escucha radio cada día|Mi mamá escucha radio cada día|My mom listens to the radio every day
Su papá trabaja en casa|Su papá trabaja en casa|Su papá trabaja en casa|His dad works at home
La maestra llegará al salón mañana|La maestra llegará al salón mañana|La maestra llegará al salón mañana|The teacher will arrive at the classroom tomorrow
Mi amigo almorzó tamales hoy|Mi amigo almorzó tamales hoy|Mi amigo almorzó tamales hoy|My friend ate tamales for lunch today
Mi prima dibuja un alebrije|Mi prima dibuja un alebrije|Mi prima dibuja un alebrije|My cousin draws an alebrije
Mi tío pesca en la laguna|Mi tío pesca en la laguna|Mi tío pesca en la laguna|My uncle fishes in the lagoon
Él montará bicicleta mañana|Él montará bicicleta mañana|Él montará bicicleta mañana|He will ride a bicycle tomorrow
Mi abuela hizo salsa verde|Mi abuela hizo salsa verde|Mi abuela hizo salsa verde|My grandmother made green salsa
Yo quiero ver el desfile|Yo quiero ver el desfile|Yo quiero ver el desfile|I want to see the parade
Mi mamá limpia la cocina|Mi mamá limpia la cocina|Mi mamá limpia la cocina|My mom cleans the kitchen
Nosotros comeremos gorditas mañana|Nosotros comeremos gorditas mañana|Nosotros comeremos gorditas mañana|We will eat gorditas tomorrow
Mi hermano fue al tianguis hoy|Mi hermano fue al tianguis hoy|Mi hermano fue al tianguis hoy|My brother went to the street market today
Mi prima juega con los primos|Mi prima juega con los primos|Mi prima juega con los primos|My cousin plays with the cousins
Su papá riega las plantas|Su papá riega las plantas|Su papá riega las plantas|His dad waters the plants
Ella cantará una canción norteña|Ella cantará una canción norteña|Ella cantará una canción norteña|She will sing a norteña song
Mi amigo durmió esta tarde|Mi amigo durmió esta tarde|Mi amigo durmió esta tarde|My friend slept this afternoon
Mi hermano quiere comer quesadillas|Mi hermano quiere comer quesadillas|Mi hermano quiere comer quesadillas|My brother wants to eat quesadillas
Mi abuelo lee el periódico|Mi abuelo lee el periódico|Mi abuelo lee el periódico|My grandfather reads the newspaper
Mi abuela caminará en la plaza|Mi abuela caminará en la plaza|Mi abuela caminará en la plaza|My grandmother will walk in the plaza
Él jugó futbolito ayer|Él jugó futbolito ayer|Él jugó futbolito ayer|He played table soccer yesterday
Yo quiero leche con chocolate|Yo quiero leche con chocolate|Yo quiero leche con chocolate|I want milk with chocolate
Mi hermana hierve agua|Mi hermana hierve agua|Mi hermana hierve agua|My sister boils water
Nosotros dormiremos temprano|Nosotros dormiremos temprano|Nosotros dormiremos temprano|We will sleep early
Mi mamá compró chiles ayer|Mi mamá compró chiles ayer|Mi mamá compró chiles ayer|My mom bought chiles yesterday
Mi prima corre en el parque|Mi prima corre en el parque|Mi prima corre en el parque|My cousin runs in the park
Su papá escucha noticias|Su papá escucha noticias|Su papá escucha noticias|His dad listens to the news
Mi hermano irá a la escuela mañana|Mi hermano irá a la escuela mañana|Mi hermano irá a la escuela mañana|My brother will go to school tomorrow
La maestra escribió en el pizarrón ayer|La maestra escribió en el pizarrón ayer|La maestra escribió en el pizarrón ayer|The teacher wrote on the board yesterday
Mi amigo quiere pozole|Mi amigo quiere pozole|Mi amigo quiere pozole|My friend wants pozole
Mi tío trabaja en la obra|Mi tío trabaja en la obra|Mi tío trabaja en la obra|My uncle works at the construction site
Mi abuela tomará té esta tarde|Mi abuela tomará té esta tarde|Mi abuela tomará té esta tarde|My grandmother will drink tea this afternoon
Él cenó sopes anoche|Él cenó sopes anoche|Él cenó sopes anoche|He ate sopes last night
Mi hermano ve luchas|Mi hermano ve luchas|Mi hermano ve luchas|My brother watches wrestling
Mi mamá abre la ventana|Mi mamá abre la ventana|Mi mamá abre la ventana|My mom opens the window
Nosotros jugaremos en la calle mañana|Nosotros jugaremos en la calle mañana|Nosotros jugaremos en la calle mañana|We will play in the street tomorrow
Su papá lavó el carro ayer|Su papá lavó el carro ayer|Su papá lavó el carro ayer|His dad washed the car yesterday