彼が部屋を出るが早いか電話が鳴った|彼が部屋を出るが早いか電話が鳴った|かれがへやをでるがはやいかでんわがなった|No sooner had he left the room than the phone rang.
ドアを開けるや否や子供たちが飛び込んできた|ドアを開けるや否や子供たちが飛び込んできた|どあをあけるやいなやこどもたちがとびこんできた|The moment I opened the door, the children rushed in.
この本を読むなり感動して涙が出た|この本を読むなり感動して涙が出た|このほんをよむなりかんどうしてなみだがでた|As soon as I read this book, I was moved to tears.
母が料理を作るそばから弟が食べ始める|母が料理を作るそばから弟が食べ始める|ははがりょうりをつくるそばからおとうとがたべはじめる|No sooner does Mom cook than my brother starts eating.
大学を卒業してからというものは仕事に追われている|大学を卒業してからというものは仕事に追われている|だいがくをそつぎょうしてからというものはしごとに追われている|Ever since graduating from university, I’ve been swamped with work.
危機にあって彼は冷静さを保った|危機にあって彼は冷静さを保った|ききにあってかれはれいせいさをたもった|In the face of a crisis, he remained calm.
新製品を皮切りに会社は成長を遂げた|新製品を皮切りに会社は成長を遂げた|しんせいひんをかわきりにかいしゃはせいちょうをとげた|Starting with the new product, the company achieved growth.
朝から晩に至るまで研究に没頭した|朝から晩に至るまで研究に没頭した|あさからばんにいたるまでけんきゅうにぼっとうした|I immersed myself in research from morning till night.
今月を限りにこの仕事を辞めるつもりだ|今月を限りにこの仕事を辞めるつもりだ|こんげつをかぎりにこのしごとをやめるつもりだ|I plan to quit this job at the end of this monthをもってプロジェクトが終了した|会議をもってプロジェクトが終了した|かいぎをもってぷろじぇくとがしゅうりょうした|The project concluded with the meeting.
彼の実力はそんなものといったところだ|彼の実力はそんなものといったところだ|かれのじつりょくはそんなものといったところだ|His ability is about that level, I’d say.
雨が降るが早いか傘を手に持った|雨が降るが早いか傘を手に持った|あめがふるがはやいかかさをてにもった|No sooner did it start raining than I grabbed an umbrella.
電車に乗るや否や眠ってしまった|電車に乗るや否や眠ってしまった|でんしゃにのるやいなやねむってしまった|The moment I got on the train, I fell asleep.
その話を聞くなり笑いが止まらなかった|その話を聞くなり笑いが止まらなかった|そのはなしをきくなりわらいがとまらなかった|As soon as I heard that story, I couldn’t stop laughing.
父が掃除するそばから猫が毛を散らす|父が掃除するそばから猫が毛を散らす|とうがそうじするそばからねこがけをちらす|No sooner does Dad clean than the cat sheds fur.
日本に来てからというものは毎日驚いている|日本に来てからというものは毎日驚いている|にほんにきてからというものはまいにちおどろいている|Ever since coming to Japan, I’ve been surprised every day.
災害にあって地域が団結した|災害にあって地域が団結した|さいがいにあってちいきがだんけつした|In the wake of the disaster, the community came together.
東京オリンピックを皮切りとして観光業が回復した|東京オリンピックを皮切りとして観光業が回復した|とうきょうおりんぴっくをかわきりとしてかんこうぎょうがかいふくした|With the Tokyo Olympics as a starting point, tourism recovered.
小学生から大学生に至るまで全員参加した|小学生から大学生に至るまで全員参加した|しょうがくせいからだいがくせいにいたるまでぜんいんさんかした|Everyone from elementary to university students participated.
今日を限りにタバコをやめようと思う|今日を限りにタバコをやめようと思う|きょうをかぎりにたばこをやめようとおもう|I think I’ll quit smoking as of today.
握手をもって交渉が成立した|握手をもって交渉が成立した|あくしゅをもってこうしょうがせいりつした|The negotiation was settled with a handshake.
彼女の努力はこれといったところだ|彼女の努力はこれといったところだ|かのじょのどりょくはこれといったところだ|Her effort is about this much, I suppose.
試験が終わるが早いか友達と遊びに行った|試験が終わるが早いか友達と遊びに行った|しけんがおわるがはやいかともだちとあそびにいった|No sooner had the exam ended than I went out with friends.
ニュースを見るや否や不安になった|ニュースを見るや否や不安になった|にゅーすをみるやいなやふあんになった|The moment I saw the news, I felt anxious.
新しい技術を学ぶなり自信がついた|新しい技術を学ぶなり自信がついた|あたらしいぎじゅつをまなぶなりじしんがついた|As soon as I learned the new technology, I gained confidence.
姉が洗濯するそばから雨が降り出した|姉が洗濯するそばから雨が降り出した|あねがせんたくするそばからあめがふりだした|No sooner did my sister do laundry than it started raining.
転職してからというものは生活が安定した|転職してからというものは生活が安定した|てんしょくしてからというものはせいかつがあんていした|Ever since changing jobs, my life has stabilized.
困難にあって彼の真価が発揮された|困難にあって彼の真価が発揮された|こんなんにあってかれのしんかがはっきされた|In times of difficulty, his true worth shone through.
新店舗を皮切りに事業が拡大した|新店舗を皮切りに事業が拡大した|しんてんぽをかわきりにじぎょうがかくだいした|Starting with the new store, the business expanded.
子供から大人に至るまで楽しめる祭りだ|子供から大人に至るまで楽しめる祭りだ|こどもからおとなにいたるまでたのしめるまつりだ|It’s a festival enjoyable for everyone from kids to adults.
今週を限りに夜更かしをやめる|今週を限りに夜更かしをやめる|こんしゅうをかぎりによふかしをやめる|I’ll stop staying up late as of this week.
署名をもって契約が完了した|署名をもって契約が完了した|しょめいをもってけいやくがかんりょうした|The contract was completed with a signature.
その結果は予想通りといったところだ|その結果は予想通りといったところだ|そのけっかはよそうどおりといったところだ|The result is about as expected, I’d say.
飛行機が着陸するが早いか荷物を取りに行った|飛行機が着陸するが早いか荷物を取りに行った|ひこうきがちゃくりくするがはやいかにもつをとりにいった|No sooner had the plane landed than I went to get my luggage.
電話が鳴るや否や急いで受付に向かった|電話が鳴るや否や急いで受付に向かった|でんわがなるやいなやいそいでうけつけにむかった|The moment the phone rang, I rushed to the reception.
その映画を見るなり心が温まった|その映画を見るなり心が温まった|そのえいがをみるなりこころがあたたまった|As soon as I watched that movie, my heart warmed.
先生が生徒を褒めるそばから宿題を忘れる|先生が生徒を褒めるそばから宿題を忘れる|せんせいがせいとをほめるそばからしゅくだいをわすれる|No sooner does the teacher praise the students than they forget homework.
海外に住んでからというものは視野が広がった|海外に住んでからというものは視野が広がった|かいがいにすんでからというものはしやがひろがった|Ever since living abroad, my perspective has broadened.
戦争にあって家族の絆が強まった|戦争にあって家族の絆が強まった|せんそうにあってかぞくのきずながつよまった|Amid the war, family bonds strengthened.
新しい法律を皮切りとして改革が進んだ|新しい法律を皮切りとして改革が進んだ|あたらしいほうりつをかわきりとしてかいかくがすすんだ|With the new law as a starting point, reforms progressed.
春から冬に至るまで花が咲き続ける|春から冬に至るまで花が咲き続ける|はるからふゆにいたるまではながさきつづける|Flowers continue blooming from spring to winter.
明日を限りにゲームを控えるつもりだ|明日を限りにゲームを控えるつもりだ|あしたをかぎりにげーむをひかえるつもりだ|I plan to cut back on games starting tomorrow.
拍手をもって式典が締めくくられた|拍手をもって式典が締めくくられた|はくしゅをもってしきてんがしめくくられた|The ceremony concluded with applause.
彼の知識はそれほどといったところだ|彼の知識はそれほどといったところだ|かれのちしきはそれほどといったところだ|His knowledge is about that much, I suppose.
授業が終わるが早いか生徒が帰り始めた|授業が終わるが早いか生徒が帰り始めた|じゅぎょうがおわるがはやいかせいとがかえりはじめた|No sooner had the class ended than students started leaving.
友達が来るや否やお菓子を出し始めた|友達が来るや否やお菓子を出し始めた|ともだちがくるやいなやおかしをだしはじめた|The moment my friend arrived, I started serving snacks.
その音楽を聴くなり涙がこぼれた|その音楽を聴くなり涙がこぼれた|そのおんがくをきくなりなみだがこぼれた|As soon as I heard that music, tears spilled out.
兄が絵を描くそばから妹が色を塗る|兄が絵を描くそばから妹が色を塗る|あにがえをかくそばからいもうとがいろをぬる|No sooner does my brother draw than my sister colors it.
結婚してからというものは幸せが続いている|結婚してからというものは幸せが続いている|けっこんしてからというものはしあわせがつづいている|Ever since getting married, happiness has continued.
病気にあっても彼は希望を失わなかった|病気にあっても彼は希望を失わなかった|びょうきにあってもかれはきぼうをうしなわなかった|Even in illness, he didn’t lose hope.
新しい駅を皮切りに街が発展した|新しい駅を皮切りに街が発展した|あたらしいえきをかわきりにまちがはってんした|Starting with the new station, the town developed.
幼稚園から高校に至るまで友達がいた|幼稚園から高校に至るまで友達がいた|ようちえんからこうこうにいたるまでともだちがいた|I had friends from kindergarten to high school.
今夜を限りに夜食をやめる|今夜を限りに夜食をやめる|こんやをかぎりにやしょくをやめる|I’ll stop late-night snacks as of tonight.
笑顔をもって別れを告げた|笑顔をもって別れを告げた|えがおをもってわかれをつげた|We parted with smiles.
その計画は失敗といったところだ|その計画は失敗といったところだ|そのけいかくはしっぱいといったところだ|That plan was a failure, I’d say.
太陽が昇るが早いか鳥が鳴き始めた|太陽が昇るが早いか鳥が鳴き始めた|たいようがのぼるがはやいかとりがないはじめた|No sooner had the sun risen than the birds started chirping.
手紙を読むや否や返事を書いた|手紙を読むや否や返事を書いた|てがみをよむやいなやへんじをかいた|The moment I read the letter, I wrote a reply.
新しい仕事を始めるなり疲れを感じた|新しい仕事を始めるなり疲れを感じた|あたらしいしごとをはじめるなりつかれをかんじた|As soon as I started the new job, I felt tired.
子供が寝るそばから親が起きてしまう|子供が寝るそばから親が起きてしまう|こどもがねるそばからおやがおきてしまう|No sooner do the kids sleep than the parents wake up.
引っ越してからというものは友達が増えた|引っ越してからというものは友達が増えた|ひっこししてからというものはともだちがふえた|Ever since moving, I’ve made more friends.
貧困にあって彼女は努力を続けた|貧困にあって彼女は努力を続けた|ひんこんにあってかのじょはどりょくをつづけた|In poverty, she kept working hard.
展示会を皮切りとして売上が伸びた|展示会を皮切りとして売上が伸びた|てんじかいをかわきりとしてうりあげがのびた|Starting with the exhibition, sales increased.
過去から現在に至るまで歴史を学んだ|過去から現在に至るまで歴史を学んだ|かこからげんざいにいたるまでれきしをまなんだ|I studied history from the past to the present.
来週を限りに残業を減らすつもりだ|来週を限りに残業を減らすつもりだ|らいしゅうをかぎりにざんぎょうをへらすつもりだ|I plan to reduce overtime starting next week.
言葉をもって感謝を伝えた|言葉をもって感謝を伝えた|ことばをもってかんしゃをつたえた|I expressed gratitude with words.
彼の態度は冷たいといったところだ|彼の態度は冷たいといったところだ|かれのたいどはつめたいといったところだ|His attitude is cold, I’d say.
試合が始まるが早いか観客が叫んだ|試合が始まるが早いか観客が叫んだ|しあいがはじまるがはやいかかんきゃくがさけんだ|No sooner had the game started than the crowd shouted.
鍵を開けるや否や犬が飛び出してきた|鍵を開けるや否や犬が飛び出してきた|かぎをあけるやいなやいぬがとびだしてきた|The moment I unlocked the door, the dog ran out.
その絵を見るなり感嘆の声が上がった|その絵を見るなり感嘆の声が上がった|そのえをみるなりかんたんのこえがあがった|As soon as they saw the painting, exclamations arose.
祖母が片付けるそばから孫が散らかす|祖母が片付けるそばから孫が散らかす|そぼがかたづけるそばからまごがちらかす|No sooner does Grandma tidy up than the grandkids mess it up.
旅行に行ってからというものは写真が趣味になった|旅行に行ってからというものは写真が趣味になった|りょこうにいってからというものはしゃしんがしゅみになった|Ever since traveling, photography has become my hobby.
不況にあって企業が協力した|不況にあって企業が協力した|ふきょうにあってきぎょうがきょうりょくした|During the recession, companies collaborated.
新しい橋を皮切りに交通が改善した|新しい橋を皮切りに交通が改善した|あたらしいはしをかわきりにこうつうがかいぜんした|Starting with the new bridge, traffic improved.
朝から夜に至るまで本を読んだ|朝から夜に至るまで本を読んだ|あさからよるにいたるまでほんをよんだ|I read books from morning till night.
今月を限りに飲み会を控える|今月を限りに飲み会を控える|こんげつをかぎりにのみかいをひかえる|I’ll cut back on drinking parties as of this month.
笑いをもって緊張が解けた|笑いをもって緊張が解けた|わらいをもってきんちょうがとけた|Laughter eased the tension.
その実験は成功といったところだ|その実験は成功といったところだ|そのじっけんはせいこうといったところだ|That experiment was a success, I’d say.
電気がつくが早いか子供が起きた|電気がつくが早いか子供が起きた|でんきがつくがはやいかこどもがおきた|No sooner did the lights turn on than the kids woke up.
店に入るや否や店員が挨拶した|店に入るや否や店員が挨拶した|みせにはいるやいなやてんいんがあいさつした|The moment I entered the store, the clerk greeted me.
新しい料理を作るなり家族が喜んだ|新しい料理を作るなり家族が喜んだ|あたらしいりょうりをつくるなりかぞくがよろこんだ|As soon as I made the new dish, my family was delighted.
上司が指示するそばから部下が動く|上司が指示するそばから部下が動く|じょうしがしじするそばからぶかがうごく|No sooner does the boss give orders than the staff act.
子供が生まれてからというものは忙しい|子供が生まれてからというものは忙しい|こどもがうまれてからというものはいそがしい|Ever since the child was born, I’ve been busy.
嵐にあって船が強くなった|嵐にあって船が強くなった|あらしにあってふねがつよくなった|In the storm, the ship grew stronger.
新しい工場を皮切りに雇用が増えた|新しい工場を皮切りに雇用が増えた|あたらしいこうじょうをかわきりにこようがふえた|Starting with the new factory, employment rose.
昔から今に至るまで伝統が続いている|昔から今に至るまで伝統が続いている|むかしからいまにいたるまででんとうがつづいている|Traditions have continued from the past to now.
今日を限りに甘いものを控える|今日を限りに甘いものを控える|きょうをかぎりにあまいものをひかえる|I’ll cut back on sweets as of today.
涙をもって別れが告げられた|涙をもって別れが告げられた|なみだをもってわかれがつげられた|The farewell was marked with tears.
彼の才能は並といったところだ|彼の才能は並といったところだ|かれのさいのうはなみといったところだ|His talent is average, I’d say.
雨が止むが早いか外に出かけた|雨が止むが早いか外に出かけた|あめがやむがはやいかそとにでかけた|No sooner had the rain stopped than I went outside.
発表が終わるや否や質問が飛び交った|発表が終わるや否や質問が飛び交った|はっぴょうがおわるやいなやしつもんがとびかった|The moment the presentation ended, questions flew.
その詩を読むなり心が震えた|その詩を読むなり心が震えた|そのしをよむなりこころがふるえた|As soon as I read that poem, my heart trembled.
友達が帰るそばから寂しくなる|友達が帰るそばから寂しくなる|ともだちがかえるそばからさびしくなる|No sooner do friends leave than I feel lonely.
会社に入ってからというものは学ぶことが多い|会社に入ってからというものは学ぶことが多い|かいしゃにはいってからというものはまなぶことがおおい|Ever since joining the company, there’s been a lot to learn.
失敗にあって成長した|失敗にあって成長した|しっぱいにあってせいちょうした|Through failure, I grew.
新しい製品を皮切りに市場が活性化した|新しい製品を皮切りに市場が活性化した|あたらしいせいひんをかわきりにしじょうがかっせいかした|Starting with the new product, the market livened up.
若者から老人に至るまで愛される歌だ|若者から老人に至るまで愛される歌だ|わかものからろうじんにいたるまであいされるうただ|It’s a song loved by everyone from youth to the elderly.
今週末を限りに旅行を控える|今週末を限りに旅行を控える|こんしゅうまつをかぎりにりょこうをひかえる|I’ll cut back on travel as of this weekend.
笑顔をもって挨拶が交わされた|笑顔をもって挨拶が交わされた|えがおをもってあいさつがかわされた|Greetings were exchanged with smiles.
その努力は無駄といったところだ|その努力は無駄といったところだ|そのどりょくはむだといったところだ|That effort was in vain, I’d say.
風が吹くが早いか雲が動き出した|風が吹くが早いか雲が動き出した|かぜがふくがはやいかくもがうごきだした|No sooner did the wind blow than the clouds started moving.