Tôi ăn sáng mỗi ngày|Tôi ăn sáng mỗi ngày|Tôi ăn sáng mỗi ngày|I eat breakfast every day
Bạn tôi đã đến trường hôm qua|Bạn tôi đã đến trường hôm qua|Bạn tôi đã đến trường hôm qua|My friend went to school yesterday
Mẹ đang nấu cơm trong bếp|Mẹ đang nấu cơm trong bếp|Mẹ đang nấu cơm trong bếp|Mother is cooking rice in the kitchen
Anh ấy sẽ đi chơi ngày mai|Anh ấy sẽ đi chơi ngày mai|Anh ấy sẽ đi chơi ngày mai|He will go out tomorrow
Bố đã xem tivi tối qua|Bố đã xem tivi tối qua|Bố đã xem tivi tối qua|Father watched TV last night
Em gái thích nghe nhạc|Em gái thích nghe nhạc|Em gái thích nghe nhạc|My younger sister likes listening to music
Chị đang uống nước ở phòng|Chị đang uống nước ở phòng|Chị đang uống nước ở phòng|My older sister is drinking water in the room
Chúng tôi sẽ học tiếng Việt|Chúng tôi sẽ học tiếng Việt|Chúng tôi sẽ học tiếng Việt|We will learn Vietnamese
Cô ấy đã ăn phở hôm qua|Cô ấy đã ăn phở hôm qua|Cô ấy đã ăn phở hôm qua|She ate pho yesterday
Ông thích uống trà mỗi sáng|Ông thích uống trà mỗi sáng|Ông thích uống trà mỗi sáng|Grandfather likes drinking tea every morning
Bà đã đi chợ sáng nay|Bà đã đi chợ sáng nay|Bà đã đi chợ sáng nay|Grandmother went to the market this morning
Em trai đang chơi bóng ngoài sân|Em trai đang chơi bóng ngoài sân|Em trai đang chơi bóng ngoài sân|My younger brother is playing ball outside
Bạn tôi sẽ đến nhà tôi|Bạn tôi sẽ đến nhà tôi|Bạn tôi sẽ đến nhà tôi|My friend will come to my house
Anh trai đã mua bánh mì|Anh trai đã mua bánh mì|Anh trai đã mua bánh mì|My older brother bought banh mi
Trẻ con thích ăn kẹo|Trẻ con thích ăn kẹo|Trẻ con thích ăn kẹo|Kids like eating candy
Mẹ đang rửa chén trong nhà|Mẹ đang rửa chén trong nhà|Mẹ đang rửa chén trong nhà|Mother is washing dishes in the house
Chú sẽ đi câu cá mai|Chú sẽ đi câu cá mai|Chú sẽ đi câu cá mai|Uncle will go fishing tomorrow
Bố đã ngủ sớm tối qua|Bố đã ngủ sớm tối qua|Bố đã ngủ sớm tối qua|Father slept early last night
Tôi thích ăn cơm với cá|Tôi thích ăn cơm với cá|Tôi thích ăn cơm với cá|I like eating rice with fish
Chị gái đang đọc sách ở bàn|Chị gái đang đọc sách ở bàn|Chị gái đang đọc sách ở bàn|My older sister is reading a book at the table
Chúng tôi sẽ đi công viên|Chúng tôi sẽ đi công viên|Chúng tôi sẽ đi công viên|We will go to the park
Cô giáo đã dạy bài mới|Cô giáo đã dạy bài mới|Cô giáo đã dạy bài mới|The teacher taught a new lesson
Em bé thích chơi đồ chơi|Em bé thích chơi đồ chơi|Em bé thích chơi đồ chơi|The baby likes playing with toys
Anh ấy đang chạy bộ sáng nay|Anh ấy đang chạy bộ sáng nay|Anh ấy đang chạy bộ sáng nay|He is jogging this morning
Bà sẽ làm bánh ngày mai|Bà sẽ làm bánh ngày mai|Bà sẽ làm bánh ngày mai|Grandmother will make cakes tomorrow
Bạn tôi đã uống cà phê|Bạn tôi đã uống cà phê|Bạn tôi đã uống cà phê|My friend drank coffee
Tôi thích nghe tiếng chim|Tôi thích nghe tiếng chim|Tôi thích nghe tiếng chim|I like hearing birds
Mẹ đang pha sữa cho em|Mẹ đang pha sữa cho em|Mẹ đang pha sữa cho em|Mother is making milk for the baby
Chú sẽ đi làm ngày mai|Chú sẽ đi làm ngày mai|Chú sẽ đi làm ngày mai|Uncle will go to work tomorrow
Anh trai đã chơi bóng đá|Bạn trai đã chơi bóng đá|Bạn trai đã chơi bóng đá|My older brother played soccer
Trẻ em đang vẽ tranh ở lớp|Trẻ em đang vẽ tranh ở lớp|Trẻ em đang vẽ tranh ở lớp|Children are drawing pictures in class
Cô ấy sẽ mua hoa tuần sau|Cô ấy sẽ mua hoa tuần sau|Cô ấy sẽ mua hoa tuần sau|She will buy flowers next week
Bố đã cắt cỏ sáng nay|Bố đã cắt cỏ sáng nay|Bố đã cắt cỏ sáng nay|Father mowed the lawn this morning
Tôi thích uống nước cam|Tôi thích uống nước cam|Tôi thích uống nước cam|I like drinking orange juice
Chị đang quét nhà ở sân|Chị đang quét nhà ở sân|Chị đang quét nhà ở sân|My sister is sweeping the yard
Chúng tôi sẽ ăn tối cùng nhau|Chúng tôi sẽ ăn tối cùng nhau|Chúng tôi sẽ ăn tối cùng nhau|We will eat dinner together
Ông đã đi bộ tối qua|Ông đã đi bộ tối qua|Ông đã đi bộ tối qua|Grandfather walked last night
Em gái thích xem phim hoạt hình|Em gái thích xem phim hoạt hình|Em gái thích xem phim hoạt hình|My younger sister likes watching cartoons
Mẹ đang giặt đồ ở nhà|Mẹ đang giặt đồ ở nhà|Mẹ đang giặt đồ ở nhà|Mother is washing clothes at home
Anh ấy sẽ học ở thư viện|Anh ấy sẽ học ở thư viện|Anh ấy sẽ học ở thư viện|He will study at the library
Bà đã nấu súp hôm qua|Bà đã nấu súp hôm qua|Bà đã nấu súp hôm qua|Grandmother cooked soup yesterday
Bạn tôi thích ăn trái cây|Bạn tôi thích ăn trái cây|Bạn tôi thích ăn trái cây|My friend likes eating fruit
Chú đang sửa xe đạp|Chú đang sửa xe đạp|Chú đang sửa xe đạp|Uncle is fixing a bicycle
Cô giáo sẽ dạy toán ngày mai|Cô giáo sẽ dạy toán ngày mai|Cô giáo sẽ dạy toán ngày mai|The teacher will teach math tomorrow
Anh trai đã ăn sáng sớm|Anh trai đã ăn sáng sớm|Anh trai đã ăn sáng sớm|My older brother ate breakfast early
Tôi thích chơi với chó|Tôi thích chơi với chó|Tôi thích chơi với chó|I like playing with the dog
Em trai đang xem tivi phòng khách|Em trai đang xem tivi phòng khách|Em trai đang xem tivi phòng khách|My younger brother is watching TV in the living room
Chúng tôi sẽ đi chợ ngày mai|Chúng tôi sẽ đi chợ ngày mai|Chúng tôi sẽ đi chợ ngày mai|We will go to the market tomorrow
Bố đã uống trà tối qua|Bố đã uống trà tối qua|Bố đã uống trà tối qua|Father drank tea last night
Chị gái thích hát bài mới|Chị gái thích hát bài mới|Chị gái thích hát bài mới|My older sister likes singing a new song
Mẹ đang trồng cây ngoài vườn|Mẹ đang trồng cây ngoài vườn|Mẹ đang trồng cây ngoài vườn|Mother is planting trees in the garden
Anh ấy sẽ mua sách tuần sau|Anh ấy sẽ mua sách tuần sau|Anh ấy sẽ mua sách tuần sau|He will buy books next week
Cô ấy đã đi ngủ sớm|Cô ấy đã đi ngủ sớm|Cô ấy đã đi ngủ sớm|She went to bed early
Bạn tôi thích uống nước lạnh|Bạn tôi thích uống nước lạnh|Bạn tôi thích uống nước lạnh|My friend likes drinking cold water
Ông đang ngồi ở ghế|Ông đang ngồi ở ghế|Ông đang ngồi ở ghế|Grandfather is sitting on the chair
Bà sẽ nấu cơm ngày mai|Bà sẽ nấu cơm ngày mai|Bà sẽ nấu cơm ngày mai|Grandmother will cook rice tomorrow
Em trai đã chạy ngoài công viên|Em trai đã chạy ngoài công viên|Em trai đã chạy ngoài công viên|My younger brother ran in the park
Tôi thích ăn bánh ngọt|Tôi thích ăn bánh ngọt|Tôi thích ăn bánh ngọt|I like eating cake
Chị đang lau bàn trong phòng|Chị đang lau bàn trong phòng|Chị đang lau bàn trong phòng|My sister is wiping the table in the room
Chúng tôi sẽ chơi bóng cuối tuần|Chúng tôi sẽ chơi bóng cuối tuần|Chúng tôi sẽ chơi bóng cuối tuần|We will play ball this weekend
Anh trai đã học bài tối qua|Anh trai đã học bài tối qua|Anh trai đã học bài tối qua|My older brother studied last night
Mẹ thích nghe radio mỗi ngày|Mẹ thích nghe radio mỗi ngày|Mẹ thích nghe radio mỗi ngày|Mother likes listening to the radio every day
Bố đang làm việc ở nhà|Bố đang làm việc ở nhà|Bố đang làm việc ở nhà|Father is working at home
Cô giáo sẽ đến lớp ngày mai|Cô giáo sẽ đến lớp ngày mai|Cô giáo sẽ đến lớp ngày mai|The teacher will come to class tomorrow
Bạn tôi đã ăn cơm trưa|Bạn tôi đã ăn cơm trưa|Bạn tôi đã ăn cơm trưa|My friend ate lunch
Em gái thích vẽ hình con mèo|Em gái thích vẽ hình con mèo|Em gái thích vẽ hình con mèo|My younger sister likes drawing cats
Chú đang câu cá ở ao|Chú đang câu cá ở ao|Chú đang câu cá ở ao|Uncle is fishing at the pond
Anh ấy sẽ đi xe đạp mai|Anh ấy sẽ đi xe đạp mai|Anh ấy sẽ đi xe đạp mai|He will ride a bicycle tomorrow
Bà đã làm nước chanh|Bà đã làm nước chanh|Bà đã làm nước chanh|Grandmother made lemonade
Tôi thích xem mặt trời mọc|Tôi thích xem mặt trời mọc|Tôi thích xem mặt trời mọc|I like watching the sunrise
Mẹ đang dọn bàn ăn|Mẹ đang dọn bàn ăn|Mẹ đang dọn bàn ăn|Mother is cleaning the dining table
Chúng tôi sẽ ăn bánh mì mai|Chúng tôi sẽ ăn bánh mì mai|Chúng tôi sẽ ăn bánh mì mai|We will eat banh mi tomorrow
Anh trai đã đi chợ sáng nay|Anh trai đã đi chợ sáng nay|Anh trai đã đi chợ sáng nay|My older brother went to the market this morning
Chị gái thích chơi với em|Chị gái thích chơi với em|Chị gái thích chơi với em|My older sister likes playing with the baby
Bố đang tưới cây ngoài sân|Bố đang tưới cây ngoài sân|Bố đang tưới cây ngoài sân|Father is watering plants outside
Cô ấy sẽ hát bài dân ca|Cô ấy sẽ hát bài dân ca|Cô ấy sẽ hát bài dân ca|She will sing a folk song
Bạn tôi đã ngủ trưa hôm qua|Bạn tôi đã ngủ trưa hôm qua|Bạn tôi đã ngủ trưa hôm qua|My friend took a nap yesterday
Em trai thích ăn cơm chiên|Em trai thích ăn cơm chiên|Em trai thích ăn cơm chiên|My younger brother likes eating fried rice
Ông đang đọc báo ở phòng|Ông đang đọc báo ở phòng|Ông đang đọc báo ở phòng|Grandfather is reading the newspaper in the room
Bà sẽ đi bộ sáng mai|Bà sẽ đi bộ sáng mai|Bà sẽ đi bộ sáng mai|Grandmother will walk tomorrow morning
Anh ấy đã chơi trò chơi|Bạn ấy đã chơi trò chơi|Bạn ấy đã chơi trò chơi|He played a game
Tôi thích uống sữa mỗi tối|Tôi thích uống sữa mỗi tối|Tôi thích uống sữa mỗi tối|I like drinking milk every night
Chị đang nấu nước nóng|Chị đang nấu nước nóng|Chị đang nấu nước nóng|My sister is boiling water
Chúng tôi sẽ đi ngủ sớm|Chúng tôi sẽ đi ngủ sớm|Chúng tôi sẽ đi ngủ sớm|We will go to bed early
Mẹ đã mua rau hôm qua|Mẹ đã mua rau hôm qua|Mẹ đã mua rau hôm qua|Mother bought vegetables yesterday
Em gái thích chạy trong sân|Em gái thích chạy trong sân|Em gái thích chạy trong sân|My younger sister likes running in the yard
Bố đang nghe tin tức|Bố đang nghe tin tức|Bố đang nghe tin tức|Father is listening to the news
Anh trai sẽ đi học chiều mai|Anh trai sẽ đi học chiều mai|Anh trai sẽ đi học chiều mai|My older brother will go to school tomorrow afternoon
Cô giáo đã viết bảng hôm qua|Cô giáo đã viết bảng hôm qua|Cô giáo đã viết bảng hôm qua|The teacher wrote on the board yesterday
Bạn tôi thích ăn cháo|Bạn tôi thích ăn cháo|Bạn tôi thích ăn cháo|My friend likes eating porridge
Chú đang làm vườn ngoài nhà|Chú đang làm vườn ngoài nhà|Chú đang làm vườn ngoài nhà|Uncle is gardening outside
Bà sẽ uống nước chiều nay|Bà sẽ uống nước chiều nay|Bà sẽ uống nước chiều nay|Grandmother will drink water this afternoon
Anh ấy đã ăn tối sớm|Anh ấy đã ăn tối sớm|Anh ấy đã ăn tối sớm|He ate dinner early
Em trai thích xem chim bay|Em trai thích xem chim bay|Em trai thích xem chim bay|My younger brother likes watching birds fly
Mẹ đang mở cửa sổ|Mẹ đang mở cửa sổ|Mẹ đang mở cửa sổ|Mother is opening the window
Chúng tôi sẽ chơi ở sân mai|Chúng tôi sẽ chơi ở sân mai|Chúng tôi sẽ chơi ở sân mai|We will play in the yard tomorrow
Bố đã rửa xe hôm qua|Bố đã rửa xe hôm qua|Bố đã rửa xe hôm qua|Father washed the car yesterday