어제 공원에서 새들이 노래했어요|어제 공원에서 새들이 노래했어요|어제 공원에서 새들이 노래했어요|Birds sang in the park yesterday
친구가 내일 시장에서 김치를 살 거예요|친구가 내일 시장에서 김치를 살 거예요|친구가 내일 시장에서 김치를 살 거예요|A friend will buy kimchi at the market tomorrow
오늘 서울 날씨가 맑아요|오늘 서울 날씨가 맑아요|오늘 서울 날씨가 맑아요|The weather in Seoul is clear today
한국 드라마가 지난주에 끝났어요|한국 드라마가 지난주에 끝났어요|한국 드라마가 지난주에 끝났어요|The Korean drama ended last week
학교에서 학생들이 내일 시험을 볼 거예요|학교에서 학생들이 내일 시험을 볼 거예요|학교에서 학생들이 내일 시험을 볼 거예요|Students will take a test at school tomorrow
주말에 가족들이 집에서 밥을 먹어요|주말에 가족들이 집에서 밥을 먹어요|주말에 가족들이 집에서 밥을 먹어요|Family members eat at home on weekends
어제 밤에 달이 예뻤어요|어제 밤에 달이 예뻤어요|어제 밤에 달이 예뻤어요|The moon was pretty last night
버스가 매일 시내로 가요|버스가 매일 시내로 가요|버스가 매일 시내로 가요|The bus goes to downtown every day
동생이 지난달에 숙제를 끝냈어요|동생이 지난달에 숙제를 끝냈어요|동생이 지난달에 숙제를 끝냈어요|My younger sibling finished homework last month
차가 내일 아침에 도착할 거예요|차가 내일 아침에 도착할 거예요|차가 내일 아침에 도착할 거예요|The tea will arrive tomorrow morning
할아버지가 어제 정원에서 꽃을 심으셨어요|할아버지가 어제 정원에서 꽃을 심으셨어요|할아버지가 어제 정원에서 꽃을 심으셨어요|Grandfather planted flowers in the garden yesterday
도서관에서 사람들이 조용히 공부해요|도서관에서 사람들이 조용히 공부해요|도서관에서 사람들이 조용히 공부해요|People study quietly in the library
공원에서 아이들이 다음 주에 놀 거예요|공원에서 아이들이 다음 주에 놀 거예요|공원에서 아이들이 다음 주에 놀 거예요|Kids will play in the park next week
매주 선생님이 한국어를 가르치세요|매주 선생님이 한국어를 가르치세요|매주 선생님이 한국어를 가르치세요|The teacher teaches Korean every week
아침에 태양이 일찍 떴어요|아침에 태양이 일찍 떴어요|아침에 태양이 일찍 떴어요|The sun rose early this morning
시장에서 아줌마가 내일 과일을 팔 거예요|시장에서 아줌마가 내일 과일을 팔 거예요|시장에서 아줌마가 내일 과일을 팔 거예요|An auntie will sell fruit at the market tomorrow
비가 어제 와서 길이 젖었어요|비가 어제 와서 길이 젖었어요|비가 어제 와서 길이 젖었어요|It rained yesterday, so the road got wet
집에서 고양이가 낮잠을 자요|집에서 고양이가 낮잠을 자요|집에서 고양이가 낮잠을 자요|The cat takes a nap at home
동생이 작년에 형을 도와줬어요|동생이 작년에 형을 도와줬어요|동생이 작년에 형을 도와줬어요|The younger sibling helped the older sibling last year
물이 다음 주에 따뜻할 거예요|물이 다음 주에 따뜻할 거예요|물이 다음 주에 따뜻할 거예요|The water will be warm next week
할머니가 어제 손자를 만났어요|할머니가 어제 손자를 만났어요|할머니가 어제 손자를 만났어요|Grandmother met her grandson yesterday
공원에서 바람이 시원하게 불어요|공원에서 바람이 시원하게 불어요|공원에서 바람이 시원하게 불어요|The wind blows coolly in the park
부모님이 다음 달에 집에 오실 거예요|부모님이 다음 달에 집에 오실 거예요|부모님이 다음 달에 집에 오실 거예요|Parents will come home next month
아침에 빵집에서 빵 냄새가 났어요|아침에 빵집에서 빵 냄새가 났어요|아침에 빵집에서 빵 냄새가 났어요|The bakery smelled like bread this morning
카페에서 사람들이 내일 친구를 만날 거예요|카페에서 사람들이 내일 친구를 만날 거예요|카페에서 사람들이 내일 친구를 만날 거예요|People will meet friends at the café tomorrow
밤에 별들이 어제 빛났어요|밤에 별들이 어제 빛났어요|밤에 별들이 어제 빛났어요|Stars shone in the sky last night
오늘 아침에 눈이 내려요|오늘 아침에 눈이 내려요|오늘 아침에 눈이 내려요|It’s snowing this morning
공원에서 강아지가 어제 뛰었어요|공원에서 강아지가 어제 뛰었어요|공원에서 강아지가 어제 뛰었어요|A dog ran in the park yesterday
친구가 다음 주에 동생에게 책을 읽어줄 거예요|친구가 다음 주에 동생에게 책을 읽어줄 거예요|친구가 다음 주에 동생에게 책을 읽어줄 거예요|A friend will read a book to my younger sibling next week
버스 정류장에서 학생들이 매일 서 있어요|버스 정류장에서 학생들이 매일 서 있어요|버스 정류장에서 학생들이 매일 서 있어요|Students stand at the bus stop every day
아빠가 어제 새 옷을 입으셨어요|아빠가 어제 새 옷을 입으셨어요|아빠가 어제 새 옷을 입으셨어요|Dad wore new clothes yesterday
한국 드라마가 다음 달에 시작할 거예요|한국 드라마가 다음 달에 시작할 거예요|한국 드라마가 다음 달에 시작할 거예요|A Korean drama will start next month
집에서 엄마가 어제 밥을 요리하셨어요|집에서 엄마가 어제 밥을 요리하셨어요|집에서 엄마가 어제 밥을 요리하셨어요|Mom cooked rice at home yesterday
아침에 사람들이 매일 샤워를 해요|아침에 사람들이 매일 샤워를 해요|아침에 사람들이 매일 샤워를 해요|People take showers every morning
여행지에서 관광객이 지난주에 사진을 찍었어요|여행지에서 관광객이 지난주에 사진을 찍었어요|여행지에서 관광객이 지난주에 사진을 찍었어요|Tourists took pictures at the travel destination last week
시계가 내일 8시에 울릴 거예요|시계가 내일 8시에 울릴 거예요|시계가 내일 8시에 울릴 거예요|The clock will ring at 8 o’clock tomorrow
시장에서 상인이 어제 채소를 정리했어요|시장에서 상인이 어제 채소를 정리했어요|시장에서 상인이 어제 채소를 정리했어요|A merchant arranged vegetables at the market yesterday
집이 다음 주에 조용할 거예요|집이 다음 주에 조용할 거예요|집이 다음 주에 조용할 거예요|The house will be quiet next week
학생들이 지난 시험에서 질문을 했어요|학생들이 지난 시험에서 질문을 했어요|학생들이 지난 시험에서 질문을 했어요|Students asked questions in the last test
친구들이 내일 쇼핑몰에서 물건을 살 거예요|친구들이 내일 쇼핑몰에서 물건을 살 거예요|친구들이 내일 쇼핑몰에서 물건을 살 거예요|Friends will buy items at the mall tomorrow
아침에 우유가 어제 식탁에 있었어요|아침에 우유가 어제 식탁에 있었어요|아침에 우유가 어제 식탁에 있었어요|There was milk on the table yesterday morning
학교에서 선생님이 매일 칠판에 써요|학교에서 선생님이 매일 칠판에 써요|학교에서 선생님이 매일 칠판에 써요|The teacher writes on the blackboard every day
한국 문화가 지난 세기에 변했어요|한국 문화가 지난 세기에 변했어요|한국 문화가 지난 세기에 변했어요|Korean culture changed last century
친구가 아침에 메시지를 보내요|친구가 아침에 메시지를 보내요|친구가 아침에 메시지를 보내요|A friend sends a message in the morning
공원에서 사람들이 내일 산책할 거예요|공원에서 사람들이 내일 산책할 거예요|공원에서 사람들이 내일 산책할 거예요|People will walk in the park tomorrow
형이 어제 아침에 피곤해 보였어요|형이 어제 아침에 피곤해 보였어요|형이 어제 아침에 피곤해 보였어요|My older brother looked tired yesterday morning
신문이 다음 주부터 집에 올 거예요|신문이 다음 주부터 집에 올 거예요|신문이 다음 주부터 집에 올 거예요|The newspaper will come to the house starting next week
동네에서 사람들이 어제 인사했어요|동네에서 사람들이 어제 인사했어요|동네에서 사람들이 어제 인사했어요|People greeted each other in the neighborhood yesterday
아침이 내일 평화로울 거예요|아침이 내일 평화로울 거예요|아침이 내일 평화로울 거예요|Tomorrow morning will be peaceful
집에서 아이들이 어제 숙제를 끝냈어요|집에서 아이들이 어제 숙제를 끝냈어요|집에서 아이들이 어제 숙제를 끝냈어요|Kids finished homework at home yesterday
친구들이 주말에 게임을 즐겨요|친구들이 주말에 게임을 즐겨요|친구들이 주말에 게임을 즐겨요|Friends enjoy games on weekends
아침에 사람들이 지난주에 이를 닦았어요|아침에 사람들이 지난주에 이를 닦았어요|아침에 사람들이 지난주에 이를 닦았어요|People brushed their teeth last week in the morning
학교에서 학생들이 내일 배울 거예요|학교에서 학생들이 내일 배울 거예요|학교에서 학생들이 내일 배울 거예요|Students will learn at school tomorrow
밤이 어제 너무 추웠어요|밤이 어제 너무 추웠어요|밤이 어제 너무 추웠어요|Last night was too cold
공원에서 사람들이 매일 자전거를 타요|공원에서 사람들이 매일 자전거를 타요|공원에서 사람들이 매일 자전거를 타요|People ride bicycles in the park every day
친구가 지난달에 동생에게 사진을 보여줬어요|친구가 지난달에 동생에게 사진을 보여줬어요|친구가 지난달에 동생에게 사진을 보여줬어요|A friend showed a picture to my younger sibling last month
라디오에서 내일 아침에 뉴스가 나올 거예요|라디오에서 내일 아침에 뉴스가 나올 거예요|라디오에서 내일 아침에 뉴스가 나올 거예요|News will come on the radio tomorrow morning
한국에서 사람들이 매일 쌀을 먹어요|한국에서 사람들이 매일 쌀을 먹어요|한국에서 사람들이 매일 쌀을 먹어요|People eat rice every day in Korea
오늘 아침이 어제보다 바빠요|오늘 아침이 어제보다 바빠요|오늘 아침이 어제보다 바빠요|This morning is busier than yesterday
공항에서 비행기가 어제 이륙했어요|공항에서 비행기가 어제 이륙했어요|공항에서 비행기가 어제 이륙했어요|A plane took off at the airport yesterday
동생이 다음 주에 감기에 걸릴 거예요|동생이 다음 주에 감기에 걸릴 거예요|동생이 다음 주에 감기에 걸릴 거예요|My younger sibling will catch a cold next week
아침에 사람들이 매일 신발을 정리해요|아침에 사람들이 매일 신발을 정리해요|아침에 사람들이 매일 신발을 정리해요|People organize their shoes every morning
한국 음식이 어제 매웠어요|한국 음식이 어제 매웠어요|한국 음식이 어제 매웠어요|Korean food was spicy yesterday
도서관에서 학생들이 다음 달에 책을 빌릴 거예요|도서관에서 학생들이 다음 달에 책을 빌릴 거예요|도서관에서 학생들이 다음 달에 책을 빌릴 거예요|Students will borrow books from the library next month
아침에 사람들이 어제 창문을 열었어요|아침에 사람들이 어제 창문을 열었어요|아침에 사람들이 어제 창문을 열었어요|People opened windows yesterday morning
공원에서 새들이 내일 나무에 앉을 거예요|공원에서 새들이 내일 나무에 앉을 거예요|공원에서 새들이 내일 나무에 앉을 거예요|Birds will sit on trees in the park tomorrow
학생들이 어제 영어를 배웠어요|학생들이 어제 영어를 배웠어요|학생들이 어제 영어를 배웠어요|Students learned English yesterday
친구가 다음 주에 동생과 약속을 지킬 거예요|친구가 다음 주에 동생과 약속을 지킬 거예요|친구가 다음 주에 동생과 약속을 지킬 거예요|A friend will keep a promise with my younger sibling next week
아침에 사람들이 매일 옷을 준비해요|아침에 사람들이 매일 옷을 준비해요|아침에 사람들이 매일 옷을 준비해요|People prepare clothes every morning
한국어가 다음 달에 쉬워질 거예요|한국어가 다음 달에 쉬워질 거예요|한국어가 다음 달에 쉬워질 거예요|Korean will become easier next month
친구가 어제 동생에게 초콜릿을 나눴어요|친구가 어제 동생에게 초콜릿을 나눴어요|친구가 어제 동생에게 초콜릿을 나눴어요|A friend shared chocolate with my younger sibling yesterday
공원에서 사람들이 지난주에 책을 읽었어요|공원에서 사람들이 지난주에 책을 읽었어요|공원에서 사람들이 지난주에 책을 읽었어요|People read books in the park last week
시장이 내일 붐빌 거예요|시장이 내일 붐빌 거예요|시장이 내일 붐빌 거예요|The market will be crowded tomorrow
아침에 사람들이 매일 거울을 봐요|아침에 사람들이 매일 거울을 봐요|아침에 사람들이 매일 거울을 봐요|People look in the mirror every morning
한국 사람들이 어제 저를 반겼어요|한국 사람들이 어제 저를 반겼어요|한국 사람들이 어제 저를 반겼어요|Korean people welcomed me yesterday
친구들이 다음 주에 공원에서 노래를 부를 거예요|친구들이 다음 주에 공원에서 노래를 부를 거예요|친구들이 다음 주에 공원에서 노래를 부를 거예요|Friends will sing songs in the park next week
아침에 사람들이 어제 머리를 빗었어요|아침에 사람들이 어제 머리를 빗었어요|아침에 사람들이 어제 머리를 빗었어요|People brushed their hair yesterday morning
한국 역사가 지난 세기에 바뀌었어요|한국 역사가 지난 세기에 바뀌었어요|한국 역사가 지난 세기에 바뀌었어요|Korean history changed last century
친구가 내일 아침을 요리할 거예요|친구가 내일 아침을 요리할 거예요|친구가 내일 아침을 요리할 거예요|A friend will cook breakfast tomorrow
공원에서 꽃들이 매일 아름다워요|공원에서 꽃들이 매일 아름다워요|공원에서 꽃들이 매일 아름다워요|Flowers in the park are beautiful every day
아침에 사람들이 지난달에 가방을 챙겼어요|아침에 사람들이 지난달에 가방을 챙겼어요|아침에 사람들이 지난달에 가방을 챙겼어요|People packed their bags last month in the morning
한국어를 배우는 학생들이 어제 많았어요|한국어를 배우는 학생들이 어제 많았어요|한국어를 배우는 학생들이 어제 많았어요|There were many students learning Korean yesterday
친구들이 내일 공원에서 사진을 찍을 거예요|친구들이 내일 공원에서 사진을 찍을 거예요|친구들이 내일 공원에서 사진을 찍을 거예요|Friends will take pictures in the park tomorrow
아침에 뉴스가 매일 TV에서 나와요|아침에 뉴스가 매일 TV에서 나와요|아침에 뉴스가 매일 TV에서 나와요|News comes on TV every morning
한국 여행이 어제 계획됐어요|한국 여행이 어제 계획됐어요|한국 여행이 어제 계획됐어요|A trip to Korea was planned yesterday
비가 다음 주에 많이 내릴 거예요|비가 다음 주에 많이 내릴 거예요|비가 다음 주에 많이 내릴 거예요|It will rain a lot next week
공원에서 강아지가 어제 사람들을 따라갔어요|공원에서 강아지가 어제 사람들을 따라갔어요|공원에서 강아지가 어제 사람들을 따라갔어요|A dog followed people in the park yesterday
아침에 사람들이 매일 얼굴을 씻어요|아침에 사람들이 매일 얼굴을 씻어요|아침에 사람들이 매일 얼굴을 씻어요|People wash their faces every morning
한국 문화가 다음 달에 인기 있을 거예요|한국 문화가 다음 달에 인기 있을 거예요|한국 문화가 다음 달에 인기 있을 거예요|Korean culture will be popular next month
친구들이 어제 집에서 공부했어요|친구들이 어제 집에서 공부했어요|친구들이 어제 집에서 공부했어요|Friends studied at home yesterday
아침에 사람들이 내일 커피를 준비할 거예요|아침에 사람들이 내일 커피를 준비할 거예요|아침에 사람들이 내일 커피를 준비할 거예요|People will prepare coffee tomorrow morning
한국에서 친구들이 매일 저를 기다려요|한국에서 친구들이 매일 저를 기다려요|한국에서 친구들이 매일 저를 기다려요|Friends wait for me every day in Korea
아침이 어제 따뜻했어요|아침이 어제 따뜻했어요|아침이 어제 따뜻했어요|Yesterday morning was warm
공원에서 바람이 내일 나무를 흔들 거예요|공원에서 바람이 내일 나무를 흔들 거예요|공원에서 바람이 내일 나무를 흔들 거예요|The wind will shake the trees in the park tomorrow
아침에 사람들이 매일 계획을 세워요|아침에 사람들이 매일 계획을 세워요|아침에 사람들이 매일 계획을 세워요|People make plans every morning
한국어를 아는 친구가 다음 주에 올 거예요|한국어를 아는 친구가 다음 주에 올 거예요|한국어를 아는 친구가 다음 주에 올 거예요|A friend who knows Korean will come next week
친구들이 어제 공연을 준비했어요|친구들이 어제 공연을 준비했어요|친구들이 어제 공연을 준비했어요|Friends prepared a performance yesterday
아침에 사람들이 내일 집을 나갈 거예요|아침에 사람들이 내일 집을 나갈 거예요|아침에 사람들이 내일 집을 나갈 거예요|People will leave the house tomorrow morning
어제 아침에 비가 많이 내렸어요|어제 아침에 비가 많이 내렸어요|어제 아침에 비가 많이 내렸어요|It rained a lot yesterday morning
언니가 내일 친구와 영화를 볼 거예요|언니가 내일 친구와 영화를 볼 거예요|언니가 내일 친구와 영화를 볼 거예요|My older sister will watch a movie with a friend tomorrow
저녁에 하늘이 맑아요|저녁에 하늘이 맑아요|저녁에 하늘이 맑아요|The sky is clear in the evening
지난주에 공항에서 비행기가 늦었어요|지난주에 공항에서 비행기가 늦었어요|지난주에 공항에서 비행기가 늦었어요|The plane was late at the airport last week
학생들이 다음 달에 도서관에 갈 거예요|학생들이 다음 달에 도서관에 갈 거예요|학생들이 다음 달에 도서관에 갈 거예요|Students will go to the library next month
가족들이 매일 저녁 TV를 봐요|가족들이 매일 저녁 TV를 봐요|가족들이 매일 저녁 TV를 봐요|Family members watch TV every evening
어제 아침에 안개가 짙었어요|어제 아침에 안개가 짙었어요|어제 아침에 안개가 짙었어요|The fog was thick yesterday morning
기차가 매일 역에서 멈춰요|기차가 매일 역에서 멈춰요|기차가 매일 역에서 멈춰요|The train stops at the station every day
오빠가 지난주에 편지를 보냈어요|오빠가 지난주에 편지를 보냈어요|오빠가 지난주에 편지를 보냈어요|My older brother sent a letter last week
꽃들이 다음 주에 필 거예요|꽃들이 다음 주에 필 거예요|꽃들이 다음 주에 필 거예요|The flowers will bloom next week
할머니가 어제 손녀와 놀아주셨어요|할머니가 어제 손녀와 놀아주셨어요|할머니가 어제 손녀와 놀아주셨어요|Grandmother played with her granddaughter yesterday
시장에서 사람들이 물건을 사요|시장에서 사람들이 물건을 사요|시장에서 사람들이 물건을 사요|People buy things at the market
아이들이 다음 주에 공원에서 뛸 거예요|아이들이 다음 주에 공원에서 뛸 거예요|아이들이 다음 주에 공원에서 뛸 거예요|Kids will run in the park next week
매일 아침 선생님이 교실에 오세요|매일 아침 선생님이 교실에 오세요|매일 아침 선생님이 교실에 오세요|The teacher comes to the classroom every morning
지난밤에 달빛이 밝았어요|지난밤에 달빛이 밝았어요|지난밤에 달빛이 밝았어요|The moonlight was bright last night
아줌마가 내일 가게에서 떡을 만들 거예요|아줌마가 내일 가게에서 떡을 만들 거예요|아줌마가 내일 가게에서 떡을 만들 거예요|An auntie will make rice cakes at the shop tomorrow
어제 바람이 세게 불어서 나무가 흔들렸어요|어제 바람이 세게 불어서 나무가 흔들렸어요|어제 바람이 세게 불어서 나무가 흔들렸어요|The wind blew hard yesterday, so the trees shook
강아지가 집에서 매일 짖어요|강아지가 집에서 매일 짖어요|강아지가 집에서 매일 짖어요|The dog barks at home every day
형이 지난달에 여동생을 만났어요|형이 지난달에 여동생을 만났어요|형이 지난달에 여동생을 만났어요|The older brother met his younger sister last month
햇빛이 다음 주에 따뜻할 거예요|햇빛이 다음 주에 따뜻할 거예요|햇빛이 다음 주에 따뜻할 거예요|The sunlight will be warm next week
할아버지가 어제 손자를 안아주셨어요|할아버지가 어제 손자를 안아주셨어요|할아버지가 어제 손자를 안아주셨어요|Grandfather hugged his grandson yesterday
거리에서 사람들이 매일 걸어요|거리에서 사람들이 매일 걸어요|거리에서 사람들이 매일 걸어요|People walk on the street every day
부모님이 다음 달에 여행을 떠나실 거예요|부모님이 다음 달에 여행을 떠나실 거예요|부모님이 다음 달에 여행을 떠나실 거예요|Parents will go on a trip next month
어제 아침에 커피 향이 진했어요|어제 아침에 커피 향이 진했어요|어제 아침에 커피 향이 진했어요|The coffee smell was strong yesterday morning
카페에서 손님들이 내일 차를 마실 거예요|카페에서 손님들이 내일 차를 마실 거예요|카페에서 손님들이 내일 차를 마실 거예요|Customers will drink tea at the café tomorrow
지난밤에 구름이 하늘을 덮었어요|지난밤에 구름이 하늘을 덮었어요|지난밤에 구름이 하늘을 덮었어요|Clouds covered the sky last night
오늘 저녁에 달이 둥글어요|오늘 저녁에 달이 둥글어요|오늘 저녁에 달이 둥글어요|The moon is round this evening
고양이가 어제 공원에서 놀았어요|고양이가 어제 공원에서 놀았어요|고양이가 어제 공원에서 놀았어요|The cat played in the park yesterday
언니가 다음 주에 동생에게 선물을 줄 거예요|언니가 다음 주에 동생에게 선물을 줄 거예요|언니가 다음 주에 동생에게 선물을 줄 거예요|My older sister will give a gift to my younger sibling next week
지하철에서 사람들이 매일 기다려요|지하철에서 사람들이 매일 기다려요|지하철에서 사람들이 매일 기다려요|People wait in the subway every day
엄마가 어제 새 신발을 사셨어요|엄마가 어제 새 신발을 사셨어요|엄마가 어제 새 신발을 사셨어요|Mom bought new shoes yesterday
한국 영화가 다음 달에 개봉할 거예요|한국 영화가 다음 달에 개봉할 거예요|한국 영화가 다음 달에 개봉할 거예요|A Korean movie will be released next month
어제 아빠가 집에서 고기를 구우셨어요|어제 아빠가 집에서 고기를 구우셨어요|어제 아빠가 집에서 고기를 구우셨어요|Dad grilled meat at home yesterday
저녁에 사람들이 매일 산책해요|저녁에 사람들이 매일 산책해요|저녁에 사람들이 매일 산책해요|People take a walk every evening
관광객이 지난주에 서울타워를 방문했어요|관광객이 지난주에 서울타워를 방문했어요|관광객이 지난주에 서울타워를 방문했어요|Tourists visited Seoul Tower last week
알람이 내일 아침에 꺼질 거예요|알람이 내일 아침에 꺼질 거예요|알람이 내일 아침에 꺼질 거예요|The alarm will turn off tomorrow morning
가게에서 주인이 어제 문을 닫았어요|가게에서 주인이 어제 문을 닫았어요|가게에서 주인이 어제 문을 닫았어요|The owner closed the shop yesterday
집이 다음 주말에 깨끗할 거예요|집이 다음 주말에 깨끗할 거예요|집이 다음 주말에 깨끗할 거예요|The house will be clean next weekend
어린이들이 지난 시험에서 잘했어요|어린이들이 지난 시험에서 잘했어요|어린이들이 지난 시험에서 잘했어요|Children did well in the last test
동생들이 내일 백화점에서 옷을 입을 거예요|동생들이 내일 백화점에서 옷을 입을 거예요|동생들이 내일 백화점에서 옷을 입을 거예요|Younger siblings will try on clothes at the department store tomorrow
어제 저녁에 우유가 다 떨어졌어요|어제 저녁에 우유가 다 떨어졌어요|어제 저녁에 우유가 다 떨어졌어요|The milk ran out last evening
교실에서 선생님이 매일 질문을 받아요|교실에서 선생님이 매일 질문을 받아요|교실에서 선생님이 매일 질문을 받아요|The teacher takes questions in the classroom every day
한국 전통이 지난 세월에 이어졌어요|한국 전통이 지난 세월에 이어졌어요|한국 전통이 지난 세월에 이어졌어요|Korean traditions have continued over the years
오빠가 아침에 동생에게 전화해요|오빠가 아침에 동생에게 전화해요|오빠가 아침에 동생에게 전화해요|My older brother calls my younger sibling in the morning
강에서 사람들이 내일 낚시할 거예요|강에서 사람들이 내일 낚시할 거예요|강에서 사람들이 내일 낚시할 거예요|People will fish in the river tomorrow
언니가 어제 아침에 배고프다고 했어요|언니가 어제 아침에 배고프다고 했어요|언니가 어제 아침에 배고프다고 했어요|My older sister said she was hungry yesterday morning
잡지가 다음 주에 집으로 올 거예요|잡지가 다음 주에 집으로 올 거예요|잡지가 다음 주에 집으로 올 거예요|A magazine will come to the house next week
거리에서 어제 사람들이 춤을 췄어요|거리에서 어제 사람들이 춤을 췄어요|거리에서 어제 사람들이 춤을 췄어요|People danced on the street yesterday
저녁이 내일 조용할 거예요|저녁이 내일 조용할 거예요|저녁이 내일 조용할 거예요|Tomorrow evening will be quiet
집에서 동생들이 어제 놀았어요|집에서 동생들이 어제 놀았어요|집에서 동생들이 어제 놀았어요|Younger siblings played at home yesterday
아이들이 주말에 공놀이를 해요|아이들이 주말에 공놀이를 해요|아이들이 주말에 공놀이를 해요|Kids play with a ball on weekends
지난주에 아침에 사람들이 늦었어요|지난주에 아침에 사람들이 늦었어요|지난주에 아침에 사람들이 늦었어요|People were late last week in the morning
학생들이 다음 학기에 공부를 시작할 거예요|학생들이 다음 학기에 공부를 시작할 거예요|학생들이 다음 학기에 공부를 시작할 거예요|Students will start studying next semester
저녁이 어제 더웠어요|저녁이 어제 더웠어요|저녁이 어제 더웠어요|Last evening was hot
호수에서 사람들이 매일 배를 타요|호수에서 사람들이 매일 배를 타요|호수에서 사람들이 매일 배를 타요|People ride boats on the lake every day
형이 지난달에 동생에게 편지를 썼어요|형이 지난달에 동생에게 편지를 썼어요|형이 지난달에 동생에게 편지를 썼어요|The older brother wrote a letter to the younger sibling last month
TV에서 내일 아침에 날씨를 알려줄 거예요|TV에서 내일 아침에 날씨를 알려줄 거예요|TV에서 내일 아침에 날씨를 알려줄 거예요|The TV will tell the weather tomorrow morning
한국에서 외국인들이 매일 한국어를 배워요|한국에서 외국인들이 매일 한국어를 배워요|한국에서 외국인들이 매일 한국어를 배워요|Foreigners learn Korean every day in Korea
저녁이 어제보다 추워요|저녁이 어제보다 추워요|저녁이 어제보다 추워요|This evening is colder than yesterday
기차역에서 기차가 어제 떠났어요|기차역에서 기차가 어제 떠났어요|기차역에서 기차가 어제 떠났어요|The train left the station yesterday
오빠가 다음 주에 아파트로 이사할 거예요|오빠가 다음 주에 아파트로 이사할 거예요|오빠가 다음 주에 아파트로 이사할 거예요|My older brother will move to an apartment next week
아침에 사람들이 매일 문을 잠가요|아침에 사람들이 매일 문을 잠가요|아침에 사람들이 매일 문을 잠가요|People lock the door every morning
김밥이 어제 맛있었어요|김밥이 어제 맛있었어요|김밥이 어제 맛있었어요|The kimbap was delicious yesterday
학교에서 학생들이 다음 달에 책을 읽을 거예요|학교에서 학생들이 다음 달에 책을 읽을 거예요|학교에서 학생들이 다음 달에 책을 읽을 거예요|Students will read books at school next month
아침에 아이들이 어제 일찍 일어났어요|아침에 아이들이 어제 일찍 일어났어요|아침에 아이들이 어제 일찍 일어났어요|Kids woke up early yesterday morning
새들이 내일 아침에 날아갈 거예요|새들이 내일 아침에 날아갈 거예요|새들이 내일 아침에 날아갈 거예요|Birds will fly tomorrow morning
학생들이 어제 수업에서 웃었어요|학생들이 어제 수업에서 웃었어요|학생들이 어제 수업에서 웃었어요|Students laughed in class yesterday
동생이 다음 주에 형과 놀 거예요|동생이 다음 주에 형과 놀 거예요|동생이 다음 주에 형과 놀 거예요|The younger sibling will play with the older sibling next week
아침에 사람들이 매일 방을 정리해요|아침에 사람들이 매일 방을 정리해요|아침에 사람들이 매일 방을 정리해요|People tidy the room every morning
날씨가 다음 달에 따뜻해질 거예요|날씨가 다음 달에 따뜻해질 거예요|날씨가 다음 달에 따뜻해질 거예요|The weather will get warm next month
오빠가 어제 동생에게 밥을 줬어요|오빠가 어제 동생에게 밥을 줬어요|오빠가 어제 동생에게 밥을 줬어요|My older brother gave rice to my younger sibling yesterday
강에서 사람들이 지난주에 수영했어요|강에서 사람들이 지난주에 수영했어요|강에서 사람들이 지난주에 수영했어요|People swam in the river last week
시장이 내일 아침에 열릴 거예요|시장이 내일 아침에 열릴 거예요|시장이 내일 아침에 열릴 거예요|The market will open tomorrow morning
아침에 사람들이 매일 침대에서 일어나요|아침에 사람들이 매일 침대에서 일어나요|아침에 사람들이 매일 침대에서 일어나요|People get out of bed every morning
한국 사람들이 어제 손님을 초대했어요|한국 사람들이 어제 손님을 초대했어요|한국 사람들이 어제 손님을 초대했어요|Korean people invited guests yesterday
동생들이 다음 주에 공원에서 소리를 지를 거예요|동생들이 다음 주에 공원에서 소리를 지를 거예요|동생들이 다음 주에 공원에서 소리를 지를 거예요|Younger siblings will shout in the park next week
아침에 사람들이 어제 졸았어요|아침에 사람들이 어제 졸았어요|아침에 사람들이 어제 졸았어요|People dozed off yesterday morning
한국 음식이 지난 세월에 변했어요|한국 음식이 지난 세월에 변했어요|한국 음식이 지난 세월에 변했어요|Korean food has changed over the years
언니가 내일 점심을 먹을 거예요|언니가 내일 점심을 먹을 거예요|언니가 내일 점심을 먹을 거예요|My older sister will eat lunch tomorrow
호수에서 물고기가 매일 헤엄쳐요|호수에서 물고기가 매일 헤엄쳐요|호수에서 물고기가 매일 헤엄쳐요|Fish swim in the lake every day
아침에 사람들이 지난달에 졸업했어요|아침에 사람들이 지난달에 졸업했어요|아침에 사람들이 지난달에 졸업했어요|People graduated last month
학생들이 다음 주에 선생님을 만날 거예요|학생들이 다음 주에 선생님을 만날 거예요|학생들이 다음 주에 선생님을 만날 거예요|Students will meet the teacher next week
아침에 뉴스가 어제 늦게 나왔어요|아침에 뉴스가 어제 늦게 나왔어요|아침에 뉴스가 어제 늦게 나왔어요|The news came late yesterday morning
한국 여행이 매일 계획돼요|한국 여행이 매일 계획돼요|한국 여행이 매일 계획돼요|A trip to Korea is planned every day
바다가 어제 파도가 셌어요|바다가 어제 파도가 셌어요|바다가 어제 파도가 셌어요|The sea had strong waves yesterday
고양이가 다음 주에 집에 올 거예요|고양이가 다음 주에 집에 올 거예요|고양이가 다음 주에 집에 올 거예요|The cat will come home next week
아침에 사람들이 어제 소식을 들었어요|아침에 사람들이 어제 소식을 들었어요|아침에 사람들이 어제 소식을 들었어요|People heard the news yesterday morning
아침에 사람들이 매일 라디오를 켜요|아침에 사람들이 매일 라디오를 켜요|아침에 사람들이 매일 라디오를 켜요|People turn on the radio every morning
친구들이 다음 주에 저를 방문할 거예요|친구들이 다음 주에 저를 방문할 거예요|친구들이 다음 주에 저를 방문할 거예요|Friends will visit me next week
어제 아침이 시끄러웠어요|어제 아침이 시끄러웠어요|어제 아침이 시끄러웠어요|Yesterday morning was noisy
산에서 바람이 매일 세게 불어요|산에서 바람이 매일 세게 불어요|산에서 바람이 매일 세게 불어요|The wind blows hard in the mountains every day
아침에 사람들이 다음 달에 계획을 바꿀 거예요|아침에 사람들이 다음 달에 계획을 바꿀 거예요|아침에 사람들이 다음 달에 계획을 바꿀 거예요|People will change plans next month
한국어를 배우는 외국인이 어제 늘었어요|한국어를 배우는 외국인이 어제 늘었어요|한국어를 배우는 외국인이 어제 늘었어요|Foreigners learning Korean increased yesterday
오빠가 지난주에 공연을 봤어요|오빠가 지난주에 공연을 봤어요|오빠가 지난주에 공연을 봤어요|My older brother watched a performance last week
아침에 사람들이 내일 시장에 갈 거예요|아침에 사람들이 내일 시장에 갈 거예요|아침에 사람들이 내일 시장에 갈 거예요|People will go to the market tomorrow morning